1111111111111
10010000000C1
100C011111001
1P011E00C0011
1111111111111