1111111111111111
1P00000000000001
1000000000000001
1001001001001001
10000N0000000001
1000000000000001
10000000000000C1
1001001001001001
1000000000000001
10000000N00000E1
1111111111111111