1111111111111
10000N0000C01
1000000000001
1P000E0000001
100000000N001
10000N0000001
1111111111111