1111111111111
10000000000C1
100C000000001
1P000E00C0001
1000000000001
1000000000001
1111111111111