1111111111111111
1P00000N00000001
1001001001001001
10000000000N0001
1001001001001001
10000000000000N1
1001001001001001
1000N00000000001
1001001001001001
100000C000N000E1
1111111111111111