1111111111111111
1P000100000000C1
10000100N0000001
1000N10000000001
1000000000000001
1000000000000001
1000N11111111111
1000010000000NC1
1000010000000001
1000010000000001
1000000000000001
10000000N0000001
1000011111110011
100001000N000001
1000E1CN00000001
1111111111111111